ALL	AO L
CLOSE	K L OW S
CLOSE(2)	K L OW Z
EIGHT	EY T
FAIREST	F EH R IH S T
FIVE	F AY V
FOUR	F AO R
GO	G OW
HELP	HH EH L P
HIDE	HH AY D
IS	IH Z
MIRROR	M IH R ER
MODULES	M AA JH UW L Z
NEXT	N EH K S T
NEXT(2)	N EH K S
NINE	N AY N
OF	AH V
ON	AA N
ON(2)	AO N
ONE	W AH N
ONE(2)	HH W AH N
OPEN	OW P AH N
SEVEN	S EH V AH N
SHOW	SH OW
SIX	S IH K S
SLEEP	S L IY P
TEN	T EH N
THE	DH AH
THE(2)	DH IY
THREE	TH R IY
TO	T UW
TO(2)	T IH
TO(3)	T AH
TWO	T UW
UP	AH P
VOICE	V OY S
WAKE	W EY K
WALL	W AO L
WHO	HH UW
